//MAP CONVERTED BY dmm2tgm.py THIS HEADER COMMENT PREVENTS RECONVERSION, DO NOT REMOVE
"d" = (
/obj/structure/window/reinforced{
	dir = 8
	},
/obj/item/target/alien,
/obj/effect/turf_decal/stripes/line{
	dir = 4
	},
/turf/open/floor/plating/airless,
/area/science/test_area)
"e" = (
/obj/structure/sign/warning/securearea{
	desc = "A warning sign which reads 'BOMB RANGE";
	name = "BOMB RANGE"
	},
/turf/closed/wall,
/area/science/test_area)
"f" = (
/obj/effect/turf_decal/stripes/line{
	dir = 4
	},
/turf/open/floor/plating/airless,
/area/science/test_area)
"h" = (
/obj/effect/turf_decal/stripes/line{
	dir = 8
	},
/turf/open/floor/plating/airless,
/area/science/test_area)
"k" = (
/obj/effect/turf_decal/stripes/corner{
	dir = 8
	},
/turf/open/floor/plating/airless,
/area/science/test_area)
"l" = (
/obj/effect/turf_decal/stripes/line{
	dir = 9
	},
/turf/open/floor/plating/airless,
/area/science/test_area)
"m" = (
/turf/closed/indestructible{
	desc = "A wall impregnated with Fixium, able to withstand massive explosions with ease";
	icon_state = "riveted";
	name = "hyper-reinforced wall"
	},
/area/science/test_area)
"p" = (
/obj/effect/turf_decal/stripes/line,
/turf/open/floor/plating/airless,
/area/science/test_area)
"s" = (
/obj/structure/chair{
	dir = 8
	},
/obj/effect/turf_decal/stripes/line{
	dir = 6
	},
/obj/machinery/camera{
	active_power_usage = 0;
	c_tag = "Bomb Test Site";
	desc = "A specially-reinforced camera with a long lasting battery, used to monitor the bomb testing site.";
	dir = 8;
	invuln = 1;
	name = "Hardened Bomb-Test Camera";
	network = list("toxins");
	use_power = 0
	},
/turf/open/floor/plating/airless,
/area/science/test_area)
"t" = (
/turf/closed/wall,
/area/science/test_area)
"u" = (
/obj/item/target,
/obj/structure/window/reinforced{
	dir = 1
	},
/obj/effect/turf_decal/stripes/line,
/turf/open/floor/plating/airless,
/area/science/test_area)
"w" = (
/obj/item/beacon,
/turf/open/floor/plating/airless,
/area/science/test_area)
"y" = (
/obj/structure/chair{
	dir = 4
	},
/turf/open/floor/plating/airless,
/area/science/test_area)
"A" = (
/obj/structure/table,
/obj/item/storage/box/mre,
/obj/effect/turf_decal/stripes/corner{
	dir = 4
	},
/turf/open/floor/plating/airless,
/area/science/test_area)
"B" = (
/turf/open/floor/plating/airless,
/area/science/test_area)
"E" = (
/obj/item/target,
/obj/structure/window/reinforced,
/obj/effect/turf_decal/stripes/line{
	dir = 1
	},
/turf/open/floor/plating/airless,
/area/science/test_area)
"H" = (
/obj/structure/chair{
	dir = 8
	},
/obj/effect/turf_decal/stripes/line{
	dir = 5
	},
/turf/open/floor/plating/airless,
/area/science/test_area)
"I" = (
/obj/structure/table,
/obj/item/flashlight/lamp,
/obj/effect/turf_decal/stripes/corner,
/turf/open/floor/plating/airless,
/area/science/test_area)
"J" = (
/obj/effect/spawner/structure/window/reinforced,
/turf/open/floor/plating/airless,
/area/science/test_area)
"N" = (
/obj/structure/chair,
/obj/effect/turf_decal/stripes/line{
	dir = 5
	},
/turf/open/floor/plating/airless,
/area/science/test_area)
"O" = (
/obj/effect/turf_decal/stripes/line{
	dir = 10
	},
/turf/open/floor/plating/airless,
/area/science/test_area)
"P" = (
/obj/structure/chair{
	dir = 1
	},
/obj/effect/turf_decal/stripes/line{
	dir = 6
	},
/turf/open/floor/plating/airless,
/area/science/test_area)
"Q" = (
/obj/structure/lattice,
/turf/open/floor/plating/asteroid/terraformable,
/area/space/nearstation)
"T" = (
/obj/effect/turf_decal/stripes/line{
	dir = 1
	},
/turf/open/floor/plating/airless,
/area/science/test_area)
"V" = (
/turf/open/floor/plating/asteroid/terraformable,
/area/space)
"Y" = (
/obj/effect/turf_decal/stripes/corner{
	dir = 1
	},
/turf/open/floor/plating/airless,
/area/science/test_area)

(1,1,1) = {"
V
V
V
V
V
V
Q
V
Q
V
V
V
V
V
V
"}
(2,1,1) = {"
V
V
V
V
V
Q
Q
V
Q
Q
V
V
V
V
V
"}
(3,1,1) = {"
V
V
V
V
Q
Q
t
h
t
Q
Q
V
V
V
V
"}
(4,1,1) = {"
V
V
V
Q
Q
e
t
f
t
e
Q
Q
V
V
V
"}
(5,1,1) = {"
V
V
Q
Q
t
t
l
h
O
t
t
Q
Q
V
V
"}
(6,1,1) = {"
V
V
Q
t
t
l
Y
B
k
O
t
t
Q
V
V
"}
(7,1,1) = {"
Q
Q
Q
J
E
T
y
w
y
p
u
J
Q
Q
Q
"}
(8,1,1) = {"
V
V
Q
t
t
N
A
B
I
P
t
t
Q
V
V
"}
(9,1,1) = {"
V
V
Q
Q
t
t
H
f
s
t
t
Q
Q
V
V
"}
(10,1,1) = {"
V
V
V
Q
Q
e
t
d
t
e
Q
Q
V
V
V
"}
(11,1,1) = {"
V
V
V
V
Q
Q
t
m
t
Q
Q
V
V
V
V
"}
(12,1,1) = {"
V
V
V
V
V
Q
Q
Q
Q
Q
V
V
V
V
V
"}
(13,1,1) = {"
V
V
V
V
V
V
Q
Q
Q
V
V
V
V
V
V
"}
(14,1,1) = {"
V
V
V
V
V
V
V
Q
V
V
V
V
V
V
V
"}
(15,1,1) = {"
V
V
V
V
V
V
V
Q
V
V
V
V
V
V
V
"}
