//MAP CONVERTED BY dmm2tgm.py THIS HEADER COMMENT PREVENTS RECONVERSION, DO NOT REMOVE
"b" = (
/obj/effect/turf_decal/stripes/line{
	dir = 5
	},
/obj/structure/chair{
	dir = 8
	},
/turf/open/floor/plating/airless,
/area/science/test_area)
"d" = (
/obj/effect/turf_decal/stripes/line{
	dir = 1
	},
/turf/open/floor/plating/airless,
/area/science/test_area)
"e" = (
/obj/structure/sign/warning/securearea{
	desc = "A warning sign which reads 'BOMB RANGE";
	name = "BOMB RANGE"
	},
/turf/closed/wall,
/area/science/test_area)
"f" = (
/obj/effect/turf_decal/stripes/line{
	dir = 4
	},
/turf/open/floor/plating/airless,
/area/science/test_area)
"g" = (
/obj/machinery/camera{
	active_power_usage = 0;
	c_tag = "Bomb Test Site";
	desc = "A specially-reinforced camera with a long lasting battery, used to monitor the bomb testing site.";
	dir = 8;
	invuln = 1;
	name = "Hardened Bomb-Test Camera";
	network = list("toxins");
	use_power = 0
	},
/obj/effect/turf_decal/stripes/line{
	dir = 4
	},
/obj/item/target/syndicate,
/turf/open/floor/plating/airless,
/area/science/test_area)
"h" = (
/obj/effect/turf_decal/stripes/line{
	dir = 8
	},
/turf/open/floor/plating/airless,
/area/science/test_area)
"i" = (
/obj/item/target/syndicate,
/obj/effect/turf_decal/stripes/corner,
/turf/open/floor/plating/airless,
/area/science/test_area)
"j" = (
/turf/open/floor/plating/asteroid/terraformable,
/area/space)
"l" = (
/obj/effect/turf_decal/stripes/line{
	dir = 9
	},
/turf/open/floor/plating/airless,
/area/science/test_area)
"m" = (
/turf/closed/indestructible{
	desc = "A wall impregnated with Fixium, able to withstand massive explosions with ease";
	icon_state = "riveted";
	name = "hyper-reinforced wall"
	},
/area/science/test_area)
"n" = (
/obj/effect/turf_decal/stripes/line{
	dir = 6
	},
/turf/open/floor/plating/airless,
/area/science/test_area)
"r" = (
/obj/effect/turf_decal/stripes/corner{
	dir = 1
	},
/turf/open/floor/plating/airless,
/area/science/test_area)
"t" = (
/turf/closed/wall,
/area/science/test_area)
"u" = (
/obj/structure/lattice,
/turf/open/floor/plating/asteroid/terraformable,
/area/space/nearstation)
"w" = (
/obj/item/beacon,
/turf/open/floor/plating/airless,
/area/science/test_area)
"y" = (
/obj/effect/turf_decal/stripes/line{
	dir = 9
	},
/obj/structure/chair,
/turf/open/floor/plating/airless,
/area/science/test_area)
"A" = (
/obj/effect/turf_decal/stripes/line{
	dir = 5
	},
/turf/open/floor/plating/airless,
/area/science/test_area)
"B" = (
/turf/open/floor/plating/airless,
/area/science/test_area)
"C" = (
/obj/effect/turf_decal/stripes/line{
	dir = 10
	},
/obj/structure/chair{
	dir = 1
	},
/turf/open/floor/plating/airless,
/area/science/test_area)
"G" = (
/obj/structure/window/reinforced,
/obj/effect/turf_decal/stripes/line{
	dir = 1
	},
/obj/item/flashlight/lamp,
/turf/open/floor/plating/airless,
/area/science/test_area)
"I" = (
/obj/item/toy/nuke,
/turf/open/floor/plating/airless,
/area/science/test_area)
"J" = (
/obj/effect/turf_decal/stripes/line{
	dir = 6
	},
/obj/structure/chair{
	dir = 8
	},
/turf/open/floor/plating/airless,
/area/science/test_area)
"K" = (
/obj/effect/turf_decal/stripes/line,
/turf/open/floor/plating/airless,
/area/science/test_area)
"O" = (
/obj/effect/turf_decal/stripes/line{
	dir = 10
	},
/turf/open/floor/plating/airless,
/area/science/test_area)
"R" = (
/obj/structure/window/reinforced{
	dir = 1
	},
/obj/effect/turf_decal/stripes/line,
/obj/item/flashlight/lamp,
/turf/open/floor/plating/airless,
/area/science/test_area)
"S" = (
/obj/effect/spawner/structure/window/reinforced,
/turf/open/floor/plating/airless,
/area/science/test_area)
"V" = (
/obj/item/target/syndicate,
/obj/effect/turf_decal/stripes/corner{
	dir = 4
	},
/turf/open/floor/plating/airless,
/area/science/test_area)
"W" = (
/obj/effect/turf_decal/stripes/corner{
	dir = 8
	},
/turf/open/floor/plating/airless,
/area/science/test_area)

(1,1,1) = {"
j
j
j
j
j
j
u
j
u
j
j
j
j
j
j
"}
(2,1,1) = {"
j
j
j
j
j
u
u
j
u
u
j
j
j
j
j
"}
(3,1,1) = {"
j
j
j
j
u
u
S
h
S
u
u
j
j
j
j
"}
(4,1,1) = {"
j
j
j
u
u
e
S
f
S
e
u
u
j
j
j
"}
(5,1,1) = {"
j
j
u
u
S
S
l
h
O
S
S
u
u
j
j
"}
(6,1,1) = {"
j
j
u
t
t
y
r
B
W
C
t
t
u
j
j
"}
(7,1,1) = {"
u
u
u
S
G
d
B
w
B
K
R
S
u
u
u
"}
(8,1,1) = {"
j
j
u
t
t
A
V
I
i
n
t
t
u
j
j
"}
(9,1,1) = {"
j
j
u
u
S
S
b
g
J
S
S
u
u
j
j
"}
(10,1,1) = {"
j
j
j
u
u
e
S
m
S
e
u
u
j
j
j
"}
(11,1,1) = {"
j
j
j
j
u
u
S
t
S
u
u
j
j
j
j
"}
(12,1,1) = {"
j
j
j
j
j
u
u
u
u
u
j
j
j
j
j
"}
(13,1,1) = {"
j
j
j
j
j
j
u
u
u
j
j
j
j
j
j
"}
(14,1,1) = {"
j
j
j
j
j
j
j
u
j
j
j
j
j
j
j
"}
(15,1,1) = {"
j
j
j
j
j
j
j
u
j
j
j
j
j
j
j
"}
